25 40
6 40
1 1
WWWWWWWWWWWWWWWWWWWWWWWWWWWWWWWWWWWWWWWW
W  W     WWW  W WWWW     WWW W  WW WWW W
WW WWWWW   W WW   DW WWW   W  W W    W W
W     WD W W WW W TW   W W WW   W WW W W
W WWW WWWWDW  W WWWWWWWW WD  DW  DW    W
W W D      WWDW W  D    DWW WWWW WWWWWWW
W WWWWWWW WW    W WWWWWWWWW    WW   D  W
WD   W  W WW WWWW W    W  WWWW    W WWWW
WWWW W WW D     W W WWWWW  W   W WW W  W
WW  DW  WWWWWWW W WD    WW WWWWW WW W WW
W  WWWWDW W  DW W WW WW D        W    WW
WW WW D W W W   W WT  WWWWWWWWW WWW WDWW
WW        W WWWWW WWW W     WD   W  W WW
W DWWWW W W W DWW WWD WWWWW   WW WWWW WW
W W W   W   W     W D   WDW WWW  W    WW
W   WWWWW WWWDWWWWWWWWW W   W   WWT WW W
WWW W   W              DWWWWW W WWWWWW W
W  DWWW W W WWWWW W WWW  WWW  W W D    W
W WWW   W WDWWWWD W W  W   W WW W WWWWWW
W WW DWWWW  WTW  WW W WWWW WTWD   W    W
W WT WDW W WWDW WWW WD   W WWW WW WWWDWW
W WW   W W W  W W   WW W D W   W  D    W
W WWWW W   W WW W WWW  W W WWWWWWWWW W W
W      WWWWW    W W   W  W           W W
WWWWWWWWWWWWWWWWWWWWWWWWWWWWWWWWWWWWWWWW
