6 6
1 1
3 4
WWWWWW
W T  W
WWWW W
WWW  W
WW  WW
D  WWW
